10
10
(0,8)
(2,0)
o.........
.o..o.o...
..o...o...
o..o..o...
.o.......o
.o.oo.oo..
.oooo...o.
......o.o.
o...o.o.o.
.o......oo
