10
10
(1,9)
(2,7)
o.........
.oo.ooooo.
.o.oo.oo..
.o.o..o.o.
...o..o.o.
..ooo.o...
..oooo..o.
.o.o..o.o.
.o.oo.ooo.
..........
